# Created by Octave 4.4.1, Thu Oct 17 17:06:42 2019 GMT <unknown@DESKTOP-FKI2Q7I>
# name: map1
# type: matrix
# rows: 10
# columns: 10
 1 1 0 0 0 0 0 0 0 0
 1 1 0 0 0 0 0 0 0 0
 0 0 0 0 0 0 0 0 0 0
 0 0 0 0 0 0 0 0 0 0
 0 0 0 0 0 0 1 1 1 0
 0 0 0 0 0 0 1 1 1 0
 0 0 0 0 0 0 0 0 0 0
 0 0 0 0 0 0 0 0 0 0
 0 0 0 0 0 0 0 0 0 0
 2 0 0 0 0 0 0 0 0 0


# name: map2
# type: matrix
# rows: 12
# columns: 14
 0 0 0 0 0 0 0 0 0 0 0 0 0 0
 0 0 0 0 0 0 0 0 0 0 0 0 0 0
 0 0 0 0 0 0 0 0 0 0 0 0 0 0
 0 0 0 0 0 0 0 0 0 0 0 0 0 0
 0 0 0 0 0 1 1 1 1 0 0 0 0 0
 0 0 0 0 0 1 1 1 1 0 0 0 0 0
 0 0 0 0 0 1 1 1 1 0 0 0 0 0
 0 0 0 0 0 1 1 1 1 0 1 1 0 0
 0 0 0 0 0 1 1 1 1 0 1 1 0 0
 0 0 0 0 0 1 1 1 1 0 1 1 0 0
 0 0 0 0 0 1 1 1 1 0 1 1 0 0
 0 0 0 0 0 1 1 1 1 0 0 0 0 2


# name: map3
# type: matrix
# rows: 14
# columns: 5
 0 0 0 0 0
 0 0 0 0 0
 0 0 1 1 1
 0 0 1 1 1
 0 0 1 1 1
 0 0 1 0 0
 0 0 1 0 0
 0 0 0 0 0
 0 0 0 0 0
 0 0 0 0 0
 0 0 0 0 0
 0 0 0 0 0
 0 0 0 0 0
 0 2 0 0 0


